11111111111111111111
01000100010100000001
01110101110101011111
00010001000101000001
11011101110101111101
00000020000000000101
01010101011101111111
01010101000100010001
01110111011111110111
01000001000000000001
01110101010111010111
01000101010100010101
01010111110111010101
01010001000001010001
11010111010101111101
00010001010100000101
11111101110111111111
00000001000000010101
11111101011101010191
00000001010001000001