111111111111111
100000000000001
101111111111101
100000000000101
101111111110101
100000000010101
101111111010101
120000001010101
101111101010101
100000191010101
101110101010101
100010101010101
101010101010101
100000000000101
111111111111111

